Sun It Rises – Fleet Foxes
Motion Picture Soundtrack – Radiohead
Collapse – Zola Jesus
About You – XXYYXX
Song for Zula – Phosphorescent
Outro – M83
First Breath After Coma – Explosions in the Sky
Take Five – The Dave Brubeck Quartet
Blue Rondo à la Turk – Jacques Loussier Trio
My Hero – Foo Fighters
Father and Son – Cat Stevens
Breathe Me – Sia
Experience – Ludovico Einaudi
Derezzed – Daft Punk
Midnight City – M83
Baba O'Riley – The Who
Cantaloupe Island – Herbie Hancock
Four Tet – Two Thousand and Seventeen
Midnight – Lane 8
Surface – Aero Flynn
Arrival of the Birds – The Cinematic Orchestra 
Words Fail – Dear Evan Hansen
It’s Quiet Uptown – Hamilton
Ghostwriter - RJD2  
Weird Fishes/Arpeggi - Radiohead
Elegia - New Order
We Move Lightly - Dustin O’Halloran
Hold Still — AMBAR LUNA
Future Visions — ODESZA (feat. Charlie Houston)
Night Owl — Galimatias
Infinite Pieces — Leon Vynehall
Alap - Talvin Singh
Taro — alt-J
Persephone — Allison Russell
Weightless -Marconi Union
Gold - Chet Faker
Elegy — Lisa Gerrard & Patrick Cassidy
Zebra – Beach House
Dust in the Gold – Shana Cleveland
Kisses – Slowdive  
Bloom – ODESZA  
Build Voice – Rival Consoles  
Places We Won’t Walk – Bruno Major  
The Colour in Anything – James Blake  
One Autumn Morning – Message to Bears 
Falling Short – Låpsley  
Holograms – Magic Man  
Canvas – Imogen Heap  
Time Moves Slow – BADBADNOTGOOD feat. Samuel T. Herring  
The Rip – Portishead  
In a Beautiful Place Out in the Country – Boards of Canada  
Crystalline – Björk  
Opus – Eric Prydz  
Ambre – Nils Frahm
Always Returning – Brian Eno
Ascending – Tom Day
Avalanche – Ghostly Kisses
Lights Out, Words Gone – Bombay Bicycle Club
Saturn – Sleeping at Last
Laser Lights – Iman Omari
Sprawl II (Mountains Beyond Mountains) – Arcade Fire
Lights Out, Words Gone – Bombay Bicycle Club
Clair de Lune – Claude Debussy
To Build a Home – The Cinematic Orchestra
Sunrise Projector – Tycho  
Bloodflows – SOHN
Silent Cause – Arms and Sleepers  
The Gutter – Soft People  
Vanishing Point – Tycho  
Cold Air – Natalie Imbruglia  
Hollow – Ásgeir  
Oceanic Feeling – Ivy Sole  
Echo Dissolve – Slow Meadow  
Time is Only a River – Eluvium  
Fever Dream – SYML  
Brief Exchanges – Tom Adams  
Elegy – Leif Vollebekk
Shimmer – Jacob Collier
Everything in Its Right Place – Radiohead
Seigfried – Frank Ocean
Lotus Flower - Radiohead
Line of Sight - ODESZA
Teardrop – Massive Attack
Retrograde – James Blake
Emerald Rush – Jon Hopkins
Slow Dancing in a Burning Room – John Mayer
Heartbeats – José González
Cerulean – Ben Böhmer
Fragments – Bonobo
A Real Hero – College & Electric Youth
Signal in the Noise – GoGo Penguin
Light Through the Veins – Jon Hopkins
Nocturne No. 2 in E-flat Major – Frédéric Chopin
Stay Alive – José González
New Jade – Caribou
Anvil – Lorn
Northern Sky – Nick Drake  
Holocene – Bon Iver  
Atlas - Battles
Iron Clad - Sleigh Bells
Frontier Psychiatrist – The Avalanches
Everything Goes My Way – Metronomy
The Road – Nick Leng
Hollow Pond – Damon Albarn
Resonance – Home  
Coral Gables – Helios  
Siren Song – Bat For Lashes
Spirals – Django Django  
Everything’s Alright – Motion City Soundtrack
Paper Trails – Darkside
Dawn Chorus – Thom Yorke
Nocturne in C-sharp Minor – Frédéric Chopin
We Could Forever – Bonobo
Strange Mercy – St. Vincent  
Satellites – Mew  
Vespertine – Björk
Transience – Kidswaste
Sunset Lover – Petit Biscuit
Divisionary (Do the Right Thing) – Ages and Ages
Melancholia – William Fitzsimmons
Horizon Variations – Max Richter
Wakin on a Pretty Day – Kurt Vile
Something in the Way – Nirvana
Shadows – Chromatics
Exit Music (For a Film) – Radiohead
Pink + White – Frank Ocean  
Weight in Gold – Gallant  
Lotus Flower – Radiohead
The Great Gig in the Sky – Pink Floyd
Ten Laws – East Forest
Ladder Song – Bright Eyes
To Zion – Lauryn Hill (feat. Carlos Santana)
Transfiguration – Sufjan Stevens
Genesis – Grimes
Archangel – Burial
Loom – Ólafur Arnalds & Bonobo
Stay Alive – José González  
Fragments – Bonobo
White Gloves – Khruangbin
Nightingale – Yanni
I Think You’re a Contra – Vampire Weekend
People II: The Reckoning – Andrew Jackson Jihad (AJJ)
The Perfect Drug – Nine Inch Nails
Frankie Teardrop – Suicide
Happiness is a Warm Gun – The Beatles
God’s Away on Business – Tom Waits
We’re All Going to Hell – The Bastard Fairies
Pink + White – Frank Ocean  
We Float – PJ Harvey  
Pink Matter – Frank Ocean  
The Only Thing – Sufjan Stevens  
Lovers’ Carvings – Bibio
Night Window – Max Richter
Signal to Noise – Peter Gabriel
Everything You Do Is a Balloon – Boards of Canada
The Breeze – Dr. Dog  
Shadows – Warpaint  
Wide Eyes – Local Natives
The Mother We Share – CHVRCHES
La Lune – Billie Marten
Light Through the Veins – Jon Hopkins
Sweet Disposition – The Temper Trap
Young Lion – Vampire Weekend
Midnight City – The XX
All We Ever Knew – The Head and the Heart
Myth – Beach House  
Sun Hands – Local Natives  
Strange Mercy – St. Vincent  
Coral Gables – Helios  
Hypnotized – Anyma & Ellie Goulding  
Revolving Door – Tate McRae  
Near Light – Ólafur Arnalds
Says – Nils Frahm
Open Eye Signal – Jon Hopkins
On the Nature of Daylight – Max Richter
Sunflower – Rex Orange County
Saturnine – Chelsea Wolfe  
The Lament – Balmorhea  
We Own the Sky – M83
Your Hand in Mine – Explosions in the Sky
Evening Star – Brian Eno & Robert Fripp
An Ending (Ascent) – Brian Eno
Unfolding - Max Cooper
Warm Shadow - Fink
Lover, You Should’ve Come Over – Jeff Buckley  
Gosh – Jamie xx  
Dawn – Jean-Michel Blais
Night Light – Jessie Ware
A Moment Apart – ODESZA
Low Mist (Day One) – Ludovico Einaudi
Midnight in a Perfect World – DJ Shadow
Siren – Nicolas Jaar
Atlas Hands – Benjamin Francis Leftwich
Signal – Sylvan Esso
Black Milk – Massive Attack  
Sirens – Pearl Jam  
Horizon – Tycho
Far Away – José González
Glue – Bicep
Intro – The xx
Unfold – Rival Consoles
Looped – Kiasmos
Shelter – Porter Robinson & Madeon
Alone in Kyoto – Air
Open – Rhye
Tearing Me Up – Bob Moses
Sunrise – Norah Jones
Lisztomania – Phoenix
Nara – E.S. Posthumus
Go! – The Chemical Brothers (feat. Q-Tip)
Divinity – Porter Robinson (feat. Amy Millan)
Gymnopédie No. 1 – Erik Satie
Riverside – Agnes Obel
Shadow Journal – Max Richter
Black Water – Apparat
La Ritournelle – Sébastien Tellier
Space Song – Beach House
Shiver – Lucy Rose
Lanterns Lit – Son Lux
Signal – Sylvan Esso  
Windowlicker – Aphex Twin  
Nothing But Blue – The Caretaker  
Everything Is Broken – Bob Dylan  
The Sound of Silence – Disturbed  
Eyes Wide Open – Gotye
Shadows – Future Islands
Low Shoulder – Toro y Moi
Deadbeat Summer – Neon Indian
Silver Soul – Beach House
Light of the Seven – Ramin Djawadi
New Person, Same Old Mistakes – Tame Impala
Paper Planes – M.I.A.
Another Thought – Brian Eno  
Shadowboxing – Lamb  

